                                                                                                                                                                                                        
                                                                                                                                                                                                        
                                                                                                                                                                                                        
                                                                                                                                                                                                        
                                                                                                                                                                                                        
                                                                                                                                                                                                        
                                                                                                                                                                                                        
                                                                                                                                                                                                        
                                                                                                                                                                                                        
                                                                                                                                                                                                        
                                                                                                                                                                                                        
                                                                                                                                                                                                        
                                                                                                                                                                                                        
                                                                               **** **                                                                                                                  
                                                          *********** ****************   *                                                                                                              
                                                       ** **  ***************************               ** *                           ***                                                              
                                              ** **    *** ****   *********************              ****                                 ****                                                          
                                            * **   * *   ****     **********************              ** *                                   **                                                         
                                         **   **  **  *** **      *  ******************                                   ***            **********          *** *                                      
                                        **   *             *          *****************                                 **     *       ***********                                                      
                                       **** *  * *** * *******         **************                                  **      ***  **********************      **                                      
                                          *******   **  ********        ************ *     *               ***          **    *** ****************************************        **                    
                    ************  *******  ****** ****   * * ****     ***************                 *  *******      *     ******  ************************************************                    
                   ************************** ********* **  * *****    **********                     ************* * *********** *****************************************************                 
                 ***************************************    **** **    ******       *****             ****  ****  ******************************************************************* ***               
                   *********************************** **     ****      *****                       ***** ****************************************************************************                  
                 ***********************************       ***          ****                      ******  *****************************************************************  ******                     
                ********* *************************        ****                                   *******   ************************************************************ **  **                         
                   ***       **********************       ********                          ***     * **  * ********************************************************        ***                         
                  **           ***********************    *********                          **    ** *   *********************************************************         ****                        
               **               ************************ **********                        ** **   ********************************************************************      **                         
                                 *********************** ************                         ** ***********************************************************************                                
                                 ******************************    **                          *********************************************************************** *                                
                                  ******************************  ****                        ************************************************************************                                  
                                 ********************************                              ******* ******** ******** *****  *************************************  *                                
                                 ****************************                              *******  ***  *****       ***  ****************************************     **                               
                                 **************************                                *****    *  ** **  ***********  ********************************** ***      *                                
                                 *************************                                 *****       *  ** ************  ************************************ **     *                                
                                 *************************                                     *******            ********************************************   ** ****                                
                                   *********************                                   ***********            ********************************************     **                                   
                                   *******************                                     ********************************************************************                                         
                                    * *********  *   **                                   ******************************* *************************************                                         
                                     * *******       **                                 ***********************************  *********************************                                          
                                      * *****                                          ***************************  ***********    ************ ************* **                                        
                                         ****    **    **                              **************************** ***********       *******   ******** *                                              
                                          **** ****    * *** *                         ***************************** *********        ******     ******* *     *                                        
                                            ******                                     ****************************** *****           ****         ******      **                                       
                                                 ***                                   ********************************                ***         *******     ***                                      
                                                   *    *****  *                        ***********************************             **          *  **     * **                                      
                                                    *** *********                        *********************************                *         **          ***                                     
                                                       *************                      ******  ************************                        *  **      **                                         
                                                       **************                                *******************                            * *    ***                                          
                                                      ****************                               ******************                             ***  ***** *   *                                    
                                                     ********************                            ****************                                **** *******   *   ***     *                       
                                                     ************************                         ***************                                  *       **        ***** * *                      
                                                      ************************                        ***************                                    **** *         **** *                          
                                                       **********************                          **************                                                *     *                            
                                                       *********************                           **************    *                                          ****  **                            
                                                        ********************                          ***************  ***                                       *******   **                           
                                                           *****************                          *************    ***                                      *************                           
                                                           ****************                            ***********     **                                    *****************        *                 
                                                           ***************                             ***********     **                                  ********************                         
                                                           ************                                **********                                          *********************                        
                                                           ************                                 *********                                          *********************                        
                                                           ***********                                   *******                                            ********************                        
                                                           **********                                    *****                                             *****     *********                          
                                                           ********                                                                                                     *****            *              
                                                          *********                                                                                                     ****              **            
                                                          *******                                                                                                                        *              
                                                           *****                                                                                                         **            *                
                                                           ****                                                                                                                     **                  
                                                           ****                                                                                                                                         
                                                           ****                                                                                                                                         
                                                           ***    *                                                                                                                                     
                                                             **                                                                                                                                         
                                                               *                                                                                                                                        
                                                                                                                                                                                                        
                                                                                                                                                                                                        
                                                                                                                                                                                                        
                                                                                                                                                                                                        
                                                                                                                                                                                                        
                                                                                                                                                                                                        
                                                                                                                                                                                                        
                                                                                                                                                                                                        
                                                                                                                                                                                                        
                                                                                                                                                                                                        
                                                                                                                                                                                                        
                                                                                                                                                                                                        
                                                                                                                                                                                                        
